2 
0 -1 1 2 
2 146 0 291 220 2 3 
0 -1 4 2 
2 146 0 291 220 2 3 
0 
0 
8 
1 -1 6 1 
1 -1 7 1 
1 -1 7 2 
1 -1 6 2 
1 -1 6 3 
1 -1 7 3 
1 -1 7 4 
1 -1 6 4 
0 
